=====================================================
           VERBOS IRREGULARES EN INGLÉS
=====================================================

INFINITIVO        | PASADO SIMPLE      | PARTICIPIO         | SIGNIFICADO
------------------|--------------------|--------------------|---------------------------

A
Arise             | Arose              | Arisen             | Surgir, Levantarse
Awake             | Awoke              | Awoken             | Despertar(se)

B
Be                | Was/Were           | Been               | Ser, Estar
Bear              | Bore               | Borne/Born         | Soportar, Llevar
Beat              | Beat               | Beaten             | Golpear, Batir
Become            | Became             | Become             | Llegar A Ser, Convertirse
Begin             | Began              | Begun              | Empezar, Comenzar
Bend              | Bent               | Bent               | Doblar, Inclinar
Bet               | Bet                | Bet                | Apostar
Bid               | Bid                | Bid                | Pujar, Ofrecer
Bind              | Bound              | Bound              | Atar, Encuadernar
Bite              | Bit                | Bitten             | Morder
Bleed             | Bled               | Bled               | Sangrar
Blow              | Blew               | Blown              | Soplar
Break             | Broke              | Broken             | Romper
Breed             | Bred               | Bred               | Criar, Reproducir
Bring             | Brought            | Brought            | Traer
Broadcast         | Broadcast          | Broadcast          | Transmitir, Emitir
Build             | Built              | Built              | Construir
Burn              | Burnt/Burned       | Burnt/Burned       | Quemar
Burst             | Burst              | Burst              | Reventar, Estallar
Buy               | Bought             | Bought             | Comprar

C
Cast              | Cast               | Cast               | Lanzar, Arrojar
Catch             | Caught             | Caught             | Atrapar, Coger
Choose            | Chose              | Chosen             | Elegir, Escoger
Cling             | Clung              | Clung              | Agarrarse, Aferrarse
Come              | Came               | Come               | Venir
Cost              | Cost               | Cost               | Costar
Creep             | Crept              | Crept              | Arrastrarse, Reptar
Cut               | Cut                | Cut                | Cortar

D
Deal              | Dealt              | Dealt              | Tratar, Repartir
Dig               | Dug                | Dug                | Cavar, Excavar
Do                | Did                | Done               | Hacer
Draw              | Drew               | Drawn              | Dibujar, Tirar
Dream             | Dreamt/Dreamed     | Dreamt/Dreamed     | Soñar
Drink             | Drank              | Drunk              | Beber
Drive             | Drove              | Driven             | Conducir
Dwell             | Dwelt              | Dwelt              | Habitar, Morar

E
Eat               | Ate                | Eaten              | Comer

F
Fall              | Fell               | Fallen             | Caer
Feed              | Fed                | Fed                | Alimentar
Feel              | Felt               | Felt               | Sentir
Fight             | Fought             | Fought             | Luchar, Pelear
Find              | Found              | Found              | Encontrar
Flee              | Fled               | Fled               | Huir
Fling             | Flung              | Flung              | Arrojar, Lanzar
Fly               | Flew               | Flown              | Volar
Forbid            | Forbade            | Forbidden          | Prohibir
Forecast          | Forecast           | Forecast           | Pronosticar
Foresee           | Foresaw            | Foreseen           | Prever
Forget            | Forgot             | Forgotten          | Olvidar
Forgive           | Forgave            | Forgiven           | Perdonar
Freeze            | Froze              | Frozen             | Congelar, Helar
Forsake           | Forsook            | Forsaken           | Abandonar

G
Get               | Got                | Got/Gotten         | Obtener, Conseguir
Give              | Gave               | Given              | Dar
Go                | Went               | Gone               | Ir
Grind             | Ground             | Ground             | Moler, Triturar
Grow              | Grew               | Grown              | Crecer, Cultivar

H
Hang              | Hung               | Hung               | Colgar
Have              | Had                | Had                | Tener, Haber
Hear              | Heard              | Heard              | Oír, Escuchar
Hide              | Hid                | Hidden             | Esconder
Hit               | Hit                | Hit                | Golpear, Pegar
Hold              | Held               | Held               | Sostener, Celebrar
Hurt              | Hurt               | Hurt               | Herir, Doler

K
Keep              | Kept               | Kept               | Guardar, Mantener
Kneel             | Knelt              | Knelt              | Arrodillarse
Knit              | Knit               | Knit               | Tejer
Know              | Knew               | Known              | Saber, Conocer

L
Lay               | Laid               | Laid               | Poner, Colocar
Lead              | Led                | Led                | Guiar, Dirigir
Lean              | Leant/Leaned       | Leant/Leaned       | Apoyarse, Inclinarse
Leap              | Leapt/Leaped       | Leapt/Leaped       | Saltar, Brincar
Learn             | Learnt/Learned     | Learnt/Learned     | Aprender
Leave             | Left               | Left               | Dejar, Salir
Lend              | Lent               | Lent               | Prestar
Let               | Let                | Let                | Dejar, Permitir
Lie               | Lay                | Lain               | Yacer, Estar Acostado
Light             | Lit                | Lit                | Encender, Iluminar
Lose              | Lost               | Lost               | Perder

M
Make              | Made               | Made               | Hacer, Fabricar
Mean              | Meant              | Meant              | Significar, Querer Decir
Meet              | Met                | Met                | Conocer, Encontrar
Mistake           | Mistook            | Mistaken           | Equivocarse
Misunderstand     | Misunderstood      | Misunderstood      | Malinterpretar

O
Overcome          | Overcame           | Overcome           | Superar, Vencer
Overtake          | Overtook           | Overtaken          | Adelantar, Alcanzar

P
Pay               | Paid               | Paid               | Pagar
Prove             | Proved             | Proven/Proved      | Probar, Demostrar
Put               | Put                | Put                | Poner, Colocar

Q
Quit              | Quit               | Quit               | Dejar, Abandonar

R
Read              | Read               | Read               | Leer
Rid               | Rid                | Rid                | Librar, Deshacer
Ride              | Rode               | Ridden             | Montar, Pasear
Ring              | Rang               | Rung               | Sonar, Llamar
Rise              | Rose               | Risen              | Levantarse, Subir
Run               | Ran                | Run                | Correr

S
Say               | Said               | Said               | Decir
See               | Saw                | Seen               | Ver
Seek              | Sought             | Sought             | Buscar
Sell              | Sold               | Sold               | Vender
Send              | Sent               | Sent               | Enviar
Set               | Set                | Set                | Poner, Establecer
Sew               | Sewed              | Sewn/Sewed         | Coser
Shake             | Shook              | Shaken             | Agitar, Sacudir
Shine             | Shone              | Shone              | Brillar
Shoot             | Shot               | Shot               | Disparar
Show              | Showed             | Shown              | Mostrar
Shrink            | Shrank             | Shrunk             | Encoger
Shut              | Shut               | Shut               | Cerrar
Sing              | Sang               | Sung               | Cantar
Sink              | Sank               | Sunk               | Hundir
Sit               | Sat                | Sat                | Sentarse
Sleep             | Slept              | Slept              | Dormir
Slide             | Slid               | Slid               | Resbalar, Deslizar
Smell             | Smelt/Smelled      | Smelt/Smelled      | Oler
Speak             | Spoke              | Spoken             | Hablar
Speed             | Sped               | Sped               | Acelerar
Spell             | Spelt/Spelled      | Spelt/Spelled      | Deletrear
Spend             | Spent              | Spent              | Gastar, Pasar (Tiempo)
Spill             | Spilt/Spilled      | Spilt/Spilled      | Derramar
Spin              | Spun               | Spun               | Girar, Hilar
Spit              | Spat               | Spat               | Escupir
Split             | Split              | Split              | Dividir, Partir
Spread            | Spread             | Spread             | Extender, Esparcir
Spring            | Sprang             | Sprung             | Saltar, Brotar
Stand             | Stood              | Stood              | Estar De Pie
Steal             | Stole              | Stolen             | Robar
Stick             | Stuck              | Stuck              | Pegar, Clavar
Sting             | Stung              | Stung              | Picar (Insecto)
Stink             | Stank              | Stunk              | Apestar
Stride            | Strode             | Stridden           | Andar A Zancadas
Strike            | Struck             | Struck/Stricken    | Golpear
Strive            | Strove             | Striven            | Esforzarse
Swear             | Swore              | Sworn              | Jurar
Sweep             | Swept              | Swept              | Barrer
Swell             | Swelled            | Swollen            | Hinchar
Swim              | Swam               | Swum               | Nadar
Swing             | Swung              | Swung              | Balancear, Columpiarse

T
Take              | Took               | Taken              | Tomar, Llevar
Teach             | Taught             | Taught             | Enseñar
Tear              | Tore               | Torn               | Rasgar, Romper
Tell              | Told               | Told               | Decir, Contar
Think             | Thought            | Thought            | Pensar
Throw             | Threw              | Thrown             | Lanzar, Tirar
Thrust            | Thrust             | Thrust             | Empujar
Tread             | Trod               | Trodden            | Pisar

U
Undergo           | Underwent          | Undergone          | Experimentar
Understand        | Understood         | Understood         | Entender, Comprender
Undertake         | Undertook          | Undertaken         | Emprender
Undo              | Undid              | Undone             | Deshacer
Upset             | Upset              | Upset              | Alterar, Disgustar

W
Wake              | Woke               | Woken              | Despertar(se)
Wear              | Wore               | Worn               | Llevar Puesto, Usar
Weave             | Wove               | Woven              | Tejer
Weep              | Wept               | Wept               | Llorar
Win               | Won                | Won                | Ganar
Wind              | Wound              | Wound              | Enrollar, Dar Cuerda
Withdraw          | Withdrew           | Withdrawn          | Retirar(se)
Withstand         | Withstood          | Withstood          | Resistir
Wring             | Wrung              | Wrung              | Retorcer, Escurrir
Write             | Wrote              | Written            | Escribir