================================================================================
                         SPORTS VOCABULARY - VOCABULARIO DE DEPORTES
================================================================================

================================================================================
                              TYPES OF SPORTS
                            (Tipos de deportes)
================================================================================

BALL SPORTS
-----------
• football (UK) / soccer (US) - fútbol
• American football - fútbol americano
• basketball - baloncesto
• volleyball - voleibol
• handball - balonmano
• tennis - tenis
• table tennis / ping pong - tenis de mesa
• badminton - bádminton
• squash - squash
• golf - golf
• baseball - béisbol
• softball - sóftbol
• cricket - críquet
• rugby - rugby
• hockey - hockey
• field hockey - hockey hierba
• ice hockey - hockey sobre hielo
• polo - polo
• lacrosse - lacrosse
• bowling - bolos

WATER SPORTS
------------
• swimming - natación
• diving - buceo/saltos
• scuba diving - buceo con equipo
• snorkeling - esnórquel
• water polo - waterpolo
• surfing - surf
• windsurfing - windsurf
• kitesurfing - kitesurf
• wakeboarding - wakeboard
• waterskiing - esquí acuático
• sailing - vela
• rowing - remo
• canoeing - piragüismo
• kayaking - kayak
• rafting - rafting
• synchronized swimming - natación sincronizada

WINTER SPORTS
-------------
• skiing - esquí
• cross-country skiing - esquí de fondo
• snowboarding - snowboard
• ice skating - patinaje sobre hielo
• figure skating - patinaje artístico
• speed skating - patinaje de velocidad
• curling - curling
• bobsled / bobsleigh - bobsled
• luge - luge
• ski jumping - salto de esquí
• biathlon - biatlón

COMBAT SPORTS / MARTIAL ARTS
----------------------------
• boxing - boxeo
• wrestling - lucha libre
• judo - judo
• karate - kárate
• taekwondo - taekwondo
• kung fu - kung fu
• aikido - aikido
• kickboxing - kickboxing
• MMA (Mixed Martial Arts) - artes marciales mixtas
• fencing - esgrima
• sumo - sumo

ATHLETICS / TRACK AND FIELD
---------------------------
• running - correr/atletismo
• sprinting - velocidad
• marathon - maratón
• hurdles - vallas
• relay race - carrera de relevos
• long jump - salto de longitud
• high jump - salto de altura
• triple jump - triple salto
• pole vault - salto con pértiga
• shot put - lanzamiento de peso
• discus throw - lanzamiento de disco
• javelin throw - lanzamiento de jabalina
• hammer throw - lanzamiento de martillo
• decathlon - decatlón
• heptathlon - heptatlón

CYCLING
-------
• cycling - ciclismo
• road cycling - ciclismo en carretera
• mountain biking - ciclismo de montaña
• BMX - BMX
• track cycling - ciclismo en pista

GYMNASTICS
----------
• gymnastics - gimnasia
• artistic gymnastics - gimnasia artística
• rhythmic gymnastics - gimnasia rítmica
• trampoline - trampolín

RACQUET SPORTS
--------------
• tennis - tenis
• badminton - bádminton
• squash - squash
• racquetball - racquetball
• padel - pádel

EXTREME SPORTS
--------------
• skateboarding - monopatín
• rock climbing - escalada
• bungee jumping - puenting
• skydiving - paracaidismo
• paragliding - parapente
• hang gliding - ala delta
• base jumping - salto base
• parkour - parkour
• motocross - motocross

OTHER SPORTS
------------
• horse riding / equestrianism - equitación
• archery - tiro con arco
• shooting - tiro
• weightlifting - halterofilia
• powerlifting - powerlifting
• CrossFit - CrossFit
• yoga - yoga
• pilates - pilates
• aerobics - aeróbic
• dance - baile
• cheerleading - animación
• triathlon - triatlón
• orienteering - orientación
• darts - dardos
• billiards / pool - billar
• chess - ajedrez
• e-sports - deportes electrónicos

================================================================================
                              SPORTS EQUIPMENT
                          (Equipamiento deportivo)
================================================================================

BALLS
-----
• ball - pelota/balón
• football - balón de fútbol
• basketball - balón de baloncesto
• tennis ball - pelota de tenis
• golf ball - bola de golf
• rugby ball - balón de rugby
• bowling ball - bola de bolos

RACQUETS & BATS
---------------
• racquet / racket - raqueta
• tennis racquet - raqueta de tenis
• badminton racquet - raqueta de bádminton
• bat - bate
• baseball bat - bate de béisbol
• cricket bat - bate de críquet
• paddle - pala
• golf club - palo de golf
• hockey stick - palo de hockey
• pool cue - taco de billar

PROTECTIVE GEAR
---------------
• helmet - casco
• goggles - gafas (de protección/natación)
• mouthguard - protector bucal
• shin guards - espinilleras
• knee pads - rodilleras
• elbow pads - coderas
• gloves - guantes
• boxing gloves - guantes de boxeo
• goalkeeper gloves - guantes de portero
• protective cup - coquilla

CLOTHING & FOOTWEAR
-------------------
• jersey / kit - camiseta/equipación
• shorts - pantalón corto
• tracksuit - chándal
• leggings - mallas
• swimsuit / swimming costume - bañador
• wetsuit - traje de neopreno
• trainers (UK) / sneakers (US) - zapatillas deportivas
• football boots / cleats - botas de fútbol
• running shoes - zapatillas de correr
• hiking boots - botas de montaña
• ski boots - botas de esquí
• ice skates - patines de hielo
• roller skates - patines de ruedas

OTHER EQUIPMENT
---------------
• net - red
• goal - portería
• basket / hoop - canasta/aro
• dartboard - diana
• target - diana/blanco
• bow - arco
• arrow - flecha
• skis - esquís
• ski poles - bastones de esquí
• snowboard - tabla de snowboard
• surfboard - tabla de surf
• skateboard - monopatín
• weights - pesas
• dumbbell - mancuerna
• barbell - barra
• treadmill - cinta de correr
• exercise bike - bicicleta estática
• jump rope / skipping rope - comba
• yoga mat - esterilla de yoga
• stopwatch - cronómetro
• whistle - silbato

================================================================================
                              PLACES
                              (Lugares)
================================================================================

• stadium - estadio
• pitch (UK) / field (US) - campo
• football pitch - campo de fútbol
• court - pista/cancha
• tennis court - pista de tenis
• basketball court - cancha de baloncesto
• track - pista de atletismo
• swimming pool - piscina
• gym / gymnasium - gimnasio
• fitness center - centro de fitness
• sports center - polideportivo
• golf course - campo de golf
• ski resort - estación de esquí
• ice rink - pista de hielo
• velodrome - velódromo
• boxing ring - ring de boxeo
• race track - circuito de carreras
• skate park - parque de patinaje
• climbing wall - rocódromo

================================================================================
                              PEOPLE IN SPORTS
                         (Personas en el deporte)
================================================================================

• athlete - atleta
• player - jugador
• footballer - futbolista
• goalkeeper / goalie - portero
• striker / forward - delantero
• midfielder - centrocampista
• defender - defensa
• captain - capitán
• substitute - suplente
• coach / manager - entrenador
• referee - árbitro
• umpire - árbitro (tenis, béisbol)
• linesman - juez de línea
• commentator - comentarista
• fan / supporter - aficionado
• spectator - espectador
• champion - campeón
• runner-up - subcampeón
• opponent - oponente/rival
• teammate - compañero de equipo
• personal trainer - entrenador personal
• physiotherapist - fisioterapeuta

================================================================================
                              ACTIONS & VERBS
                           (Acciones y verbos)
================================================================================

• to play - jugar
• to win - ganar
• to lose - perder
• to draw / to tie - empatar
• to score (a goal) - marcar (un gol)
• to kick - patear/chutar
• to throw - lanzar
• to catch - atrapar
• to hit - golpear
• to pass - pasar
• to shoot - disparar/tirar
• to dribble - regatear
• to tackle - entrar/placar
• to block - bloquear
• to serve - sacar/servir
• to spike - rematar
• to dive - tirarse/zambullirse
• to swim - nadar
• to run - correr
• to jump - saltar
• to climb - escalar
• to ski - esquiar
• to skate - patinar
• to ride (a bike/horse) - montar
• to train - entrenar
• to warm up - calentar
• to stretch - estirar
• to compete - competir
• to qualify - clasificarse
• to beat - vencer
• to defeat - derrotar
• to foul - cometer falta
• to disqualify - descalificar

================================================================================
                              COMPETITION TERMS
                       (Términos de competición)
================================================================================

• match / game - partido
• tournament - torneo
• championship - campeonato
• league - liga
• cup - copa
• World Cup - Copa del Mundo
• Olympic Games - Juegos Olímpicos
• final - final
• semi-final - semifinal
• quarter-final - cuartos de final
• round - ronda
• first half - primera parte
• second half - segunda parte
• extra time / overtime - prórroga
• penalty shootout - tanda de penaltis
• score - marcador/puntuación
• goal - gol
• point - punto
• set - set
• medal - medalla
• gold medal - medalla de oro
• silver medal - medalla de plata
• bronze medal - medalla de bronce
• trophy - trofeo
• record - récord
• personal best - mejor marca personal
• world record - récord mundial

================================================================================
                              USEFUL EXPRESSIONS
                            (Expresiones útiles)
================================================================================

• What's the score? - ¿Cuál es el marcador?
• We won 3-0. - Ganamos 3 a 0.
• It was a draw / a tie. - Fue un empate.
• He scored the winning goal. - Marcó el gol de la victoria.
• She broke the world record. - Batió el récord mundial.
• I'm a fan of... - Soy aficionado de...
• Who are you rooting for? - ¿A quién apoyas?
• May the best team win! - ¡Que gane el mejor!
• Practice makes perfect. - La práctica hace al maestro.
• No pain, no gain. - Sin esfuerzo no hay recompensa.

================================================================================
